98 98 98 98 98 98 98 98 98 98 98 98 98 98 98 98 98 98 98 98 98 98 98 98 98 98 98 98 98 98
99 31 99 99 99 99 99 99 99 99 99 99 99 99 99 99 99 99 99 99 99 99 99 99 99 99 99 99 99 98 
11 13 30 99 99 99 99 99 99 99 99 99 99 99 99 99 99 99 99 99 99 99 99 99 99 99 99 99 99 98 
17 18 24 24 25 99 99 99 99 99 99 99 99 99 99 99 32 99 99 20 99 99 10 99 99 99 99 99 99 98
98 31 99 99 99 99 32 99 33 99 99 99 99 99 99 11 12 13 99 21 99 99 99 99 10 99 99 99 99 98 
98 20 99 99 99 30 23 24 12 13 99 10 99 20 99 17 15 16 99 14 24 25 99 99 99 99 10 99 99 98 
98 21 99 99 23 24 25 99 17 16 99 99 99 22 99 99 14 16 99 21 99 99 99 99 32 20 99 99 99 98 
98 14 13 99 99 99 99 99 99 22 99 99 99 99 99 99 17 19 99 21 99 99 23 24 24 16 99 99 99 98 
31 14 16 99 32 99 99 99 99 99 99 99 99 99 99 99 99 31 99 21 99 30 99 99 99 21 99 99 99 98 
23 24 24 24 12 12 25 99 99 32 99 99 30 99 99 99 99 20 99 17 24 24 25 99 99 21 99 11 13 98 
98 31 99 99 14 16 99 99 23 24 12 12 12 25 99 99 99 21 99 99 99 99 99 99 99 21 99 14 16 98 
24 25 99 99 14 16 99 99 99 99 17 18 19 99 99 99 99 21 99 99 99 99 23 24 24 16 99 14 16 98 
98 99 99 99 17 19 99 99 99 99 99 99 99 99 99 11 13 21 99 99 99 99 99 99 99 21 99 14 16 98 
98 99 99 33 99 99 99 99 30 99 99 99 99 99 23 15 16 21 30 99 11 13 99 99 31 21 30 14 16 98 
12 12 12 12 12 12 12 12 12 12 12 12 12 12 12 12 12 12 12 12 12 12 12 12 12 12 12 12 12 12
